01001100010000000000000000000101
01001100100000000000000000000001
00010000100001001000000000000000
00001100010001000000000000000001
00101100000001000000000000000001
10001111111111111111111111111101